NO ./path_to_the_north_texture
SO ./path_to_the_south_texture
WE ./path_to_the_west_texture
EA ./path_to_the_east_texture

F 220,100,0
C 225,30,0

111   111       | 9
101111101111    | 12
10000000000111  | 14
111110010N00001 | 15
    101 101111  | 14
    1001001     | 11
  11001111      | 10
  10001         | 7
111001          | 6
10001           | 5
1011            | 3
 1              | 2
