NO ./resources/textures/WF_wall.png
EA ./resources/textures/WF_wall.png
SO ./resources/textures/WF_wall.png
WE ./resources/textures/WF_wall.png
DO ./resources/textures/door.png

F 0,0,0
C 0,0,0


 1
1N1
 1

111   111
101111101111
10000000000111
111110010N00001
    101 101111
    1001001
  11001111
  10001
111001
10001
1011
 1

