NO ./resources/textures/WF_wall.png
EA ./resources/textures/WF_wall.png
SO ./resources/textures/WF_wall.png
WE ./resources/textures/WF_wall.png
DO ./resources/textures/door.png

F 0,0,0
C 0,0,0

111111111111111111111111111111
101100000010000100000000000001
101100000010000100000000000001
101100000012111100000000000001
101100111000000000000000000001
1011001 1000000000000000000001
101100111000000001111100000001
101100000000000001000100000001
10110000000N000001111100000001
101100000000000000000000000001
100000000000000000000000000001
100000000000000000000000000001
100000000000000011111111111111
100000000000000010001000010001
111000000000000010001000010001
100000000000000010001000010001
100000100000000010001000010001
100001110000000011211112111211
100000100000000000000000000001
1000000000000000000000000000011111111111111111111111111111111111111111111111111111111111111111111111111111111111111111111111111111111111111111111111111111111111
1000000000000000000000000000000000000000000000000000000000000000000000000000000000000000000000000000000000000000000000000000000000000000000000000000000001
1111111111111111111111111111111111111111111111111111111111111111111111111111111111111111111111111111111111111111111111111111111111111111111111111111111111111111
