NO             ./path_to_the_north_texture asdasd
SO     ./path_to_the_south_texture
WE      ./path_to_the_west_texture
EA      ./path_to_the_east_texture


NO             ./path_to_the_north_texture asdasd
SO     ./path_to_the_south_texture
WE      ./path_to_the_west_texture
EA      ./path_to_the_east_texture

NO

EA./path_to_the_east_texture

F 220,100,0
C 225,30,0


F 220,100,0
C 225,10,0

111
1N11111
101N11
1111111
 1 10
 1 1
 1 1
 111




