NO             ./path_to_the_north_texture asdasd
SO     ./path_to_the_south_texture
WE      ./path_to_the_west_texture
EA      ./path_to_the_east_texture


NO             ./path_to_the_north_texture asdasd
SO     ./path_to_the_south_texture
WE      ./path_to_the_west_texture
EA      ./path_to_the_east_texture

NO

EA./path_to_the_east_texture

F 220,100,0
C 225,30,0


F 220,100,0
C 225,30,0

110
111111
10
1111
   11111
00011111
NNEESSWW
