NO ./resources/textures/bricks.png
EA ./resources/textures/bricks.png
SO ./resources/textures/bricks.png
WE ./resources/textures/bricks.png
DO ./resources/textures/door.png

F 2,48,32
C 135,206,235


111111111111111111111111111111
101100000010000100000000000001
101100000010000100000000000001
101100000012221100000000000001
101100111000000000000000000001
1011001 1000000000000000000001
101100111000000000000000000001
101100000000000000000000000001
10110000000N000000000000000001
101100000000000000000000000001
100000000000000000000000000001
100000000000000000000000000001
100000000000000011111111111101
100000000000000010001000010001
100000000000000010001000010001
100000000000000010001000010001
100000000000000010001000010001
100000000000000011211112111211
100000000000000000000000000001
100000000000000000000000000001
100000000000000000000000000001
111111111111111111111111111111

1111111111111111
1011000000100001
1011000000100001
1011000000122211
1011001110000001
1011001 10000001
1011001110000001
1011000000000001
10110000000N0001
1011000000000001
1000000000000001
1111111111111111


1111111111111111
1011000000000001
1011000000000001
1011000000000001
1011000000000001
1011000000000001
1011000000000001
1011000000000001
1011000000000001
1011000000000001
1000000000000001
1000000000000001
1000000000000001
1000000000000001
1000000000N00001
1111111111111111


