NO ./resources/textures/bricks.png
SO ./resources/textures/bricks.png
WE ./resources/textures/bricks.png
EA ./resources/textures/bricks.png
DO ./resources/textures/door.png

F 2,48,32
C 135,206,235




1111111111111111
1011000000001001
1011000000001001
1011000000001211
1011001110000001
1011001 10000001
1011001110000001
1011000000000001
10110000000N0001
1011000000000001
1000000000000001
1111111111111111


1111111111111111
1011000000000001
1011000000000001
1011000000000001
1011000000000001
1011000000000001
1011000000000001
1011000000000001
1011000000000001
1011000000000001
1000000000000001
1000000000000001
1000000000000001
1000000000000001
1000000000N00001
1111111111111111


