NO ./resources/textures/bricks.png
SO ./resources/textures/bricks.png
WE ./resources/textures/bricks.png
EA ./resources/textures/bricks.png

F 2,48,32
C 135,206,235


11111111
10100001
10100001
10000001
10000001
10E00101
10000001
11111111
