NO ./resources/textures/rainbowdirection.png
SO ./resources/textures/rainbowdirection.png
WE ./resources/textures/rainbowdirection.png
EA ./resources/textures/rainbowdirection.png
DO ./resources/textures/door.png
F 2,48,32
C 135,206,235

111111111111111111111111111111
101100000010000100000000000001
101100000010000100000000000001
101100000012221100000000000001
101100111000000000000000000001
1011001 1000000000000000000001
101100111000000000000000000001
101100000000000000000000000001
10110000000N000000000000000001
101100000000000000000000000001
100000000000000000000000000001
100000000000000000000000000001
100000000000000000000000000001
100000000000000000000000000001
100000000000000000000000000001
100000000000000000000000000001
100000000000000000000000000001
100000000000000000000000000001
100000000000000000000000000001
100000000000000000000000000001
100000000000000000000000000001
111111111111111111111111111111
