NO ./resources/textures/rainbowdirection.png
SO ./resources/textures/rainbowdirection.png
WE ./resources/textures/rainbowdirection.png
EA ./resources/textures/rainbowdirection.png

DO ./resources/textures/door.png

F 260,-99,a
C 135,206,235

1111111111111111111111111111111111111111111111111111111111111111111111
1011000000100001000000000000010000100000000100001000000000000000000001
1011000000100001000000000000010000200000000200001000000000000000000001
1011000000122211000000000000010000111111100100001000000000000000000001
1011001110000000000000000000010000100000100111111000000000000000000001
1011001 10000000000000000000010000100000100100001000000000000000000001
1011001110000000000000000000020000100000200200001000000000000000000001
1011000000000000000000000000011111100000100100001000000000000000000001
10110000000E0000000000000000010000111111100111111000000000000000000001
1011000000000000000000000000010000000000100100001000000000000000000001
1000000000000000000000000000010000000000200200001000000000000000000001
1000000000000000000000000000010000000000100100001000000000000000000001
1000000000000000111111111111011211111111110011111000000000000000000001
1000000000000000100010000100010000000000100100000000000000000000000001
1000000000000000100010000100010000000000100200000000000000000000000001
1000000000000000100010000100010000000000100100000000000000000000000001
1000000000000000100010000100011111111111100111111111100000000000000001
1000000000000000112111121112110000000000100100001000000000000000000001
1000000000000000000000000000010000000000200200001000000000000000000001
1000000000000000000000000000010000000000100100001000000000000000000001
1000000000000000000000000000010000000000100100001000000000000000000001
1111111111111111111111111111111111111111111111111111111111111111111111
